level 4 map

#######
## X ##
## X ##
## X ##
#  X ##
#  X  #
#  X  #
###  ##
#######

#######
## * ##
##B B##
## B ##
#  B ##
#  B  #
#  B  #
###  ##
#######
